          #######
     #####      #######
######                ######
#S  #E                    L#
#####                      #
#                          #
#F                         #
#                          #
#                          #
#                          #
#                          #
#####                 ######
    #####      ########
        ########
